dh_ultima_coleta,dh_equip_ligado,dh_primeira_coleta,TempoIndisponivel,TempoIndispAjustado,Equipamento,Uptime,UltimoUptime
2017-09-29 18:02:58.0,2017-09-29 18:05:59.0,2017-09-29 18:08:16.0,318,181,MSOMNOQ_SWL3,137,1304225
2017-10-01 16:17:58.0,2017-10-01 16:18:22.0,2017-10-01 16:23:58.0,360,24,MSOMNOQ_SWL3,336,166324
2017-10-01 17:05:58.0,2017-10-01 17:09:31.0,2017-10-01 17:12:20.0,382,213,MSOMNOQ_SWL3,169,2856
2017-10-01 19:02:58.0,2017-10-01 19:04:39.0,2017-10-01 19:08:59.0,361,101,MSOMNOQ_SWL3,260,6807
2017-10-01 19:17:58.0,2017-10-01 19:19:56.0,2017-10-01 19:23:58.0,360,118,MSOMNOQ_SWL3,242,800
2017-10-01 19:23:58.0,2017-10-01 19:27:14.0,2017-10-01 19:29:59.0,361,196,MSOMNOQ_SWL3,165,242
2017-10-01 20:41:58.0,2017-10-01 20:46:08.0,2017-10-01 20:50:58.0,540,250,MSOMNOQ_SWL3,290,4484
2017-10-01 21:50:58.0,2017-10-01 21:52:41.0,2017-10-01 21:56:59.0,361,103,MSOMNOQ_SWL3,258,3890
2017-10-01 21:56:59.0,2017-10-01 22:00:09.0,2017-10-01 22:03:20.0,381,190,MSOMNOQ_SWL3,191,258
2017-10-01 22:03:20.0,2017-10-01 22:05:55.0,2017-10-01 22:08:16.0,296,155,MSOMNOQ_SWL3,141,191
2017-10-02 00:44:58.0,2017-10-02 00:47:24.0,2017-10-02 00:50:16.0,318,146,MSOMNOQ_SWL3,172,9544
2017-10-02 02:08:58.0,2017-10-02 02:11:29.0,2017-10-02 02:14:12.0,314,151,MSOMNOQ_SWL3,163,4894
2017-10-07 17:14:58.0,2017-10-07 17:16:42.0,2017-10-07 17:20:58.0,360,104,MSOMNOQ_SWL3,256,486223
2017-10-07 18:14:58.0,2017-10-07 18:18:16.0,2017-10-07 18:20:43.0,345,198,MSOMNOQ_SWL3,147,3496
2017-10-07 18:20:58.0,2017-10-07 18:27:43.0,2017-10-07 19:24:58.0,3840,405,MSOMNOQ_SWL3,3435,163
2017-10-09 07:38:58.0,2017-10-09 07:40:04.0,2017-10-09 07:44:58.0,360,66,MSOMNOQ_SWL3,294,133878
2017-10-16 08:14:58.0,2017-10-16 08:17:37.0,2017-10-16 08:20:13.0,315,159,MSOMNOQ_SWL3,156,603310
2017-10-16 09:44:58.0,2017-10-16 09:48:32.0,2017-10-16 09:51:43.0,405,214,MSOMNOQ_SWL3,191,5241
2017-10-19 16:17:58.0,2017-10-19 16:20:48.0,2017-10-19 16:23:33.0,335,170,MSOMNOQ_SWL3,165,282574
2017-10-22 08:17:58.0,2017-10-22 08:20:53.0,2017-10-22 08:23:13.0,315,175,MSOMNOQ_SWL3,140,230237
2017-10-22 17:53:58.0,2017-10-22 17:54:37.0,2017-10-22 17:59:58.0,360,39,MSOMNOQ_SWL3,321,34385
2017-10-24 12:47:58.0,2017-10-24 12:50:09.0,2017-10-24 12:53:58.0,360,131,MSOMNOQ_SWL3,229,154406
2017-10-27 17:53:58.0,2017-10-27 17:57:17.0,2017-10-27 17:59:48.0,350,199,MSOMNOQ_SWL3,151,277437
2017-10-30 16:23:26.0,2017-10-30 16:25:37.0,2017-10-30 16:29:26.0,360,131,MSOMNOQ_SWL3,229,253575
2017-10-30 17:02:26.0,2017-10-30 17:04:49.0,2017-10-30 17:08:26.0,360,143,MSOMNOQ_SWL3,217,2208
2017-11-04 15:17:36.0,2017-11-04 15:21:28.0,2017-11-04 15:24:51.0,435,232,MSOMNOQ_SWL3,203,425579
2017-11-05 07:38:38.0,2017-11-05 07:41:22.0,2017-11-05 07:44:36.0,358,164,MSOMNOQ_SWL3,194,58631
2017-11-05 18:23:39.0,2017-11-05 18:26:00.0,2017-11-05 18:29:39.0,360,141,MSOMNOQ_SWL3,219,38538
2017-11-05 18:38:39.0,2017-11-05 18:40:21.0,2017-11-05 18:44:39.0,360,102,MSOMNOQ_SWL3,258,759
2017-11-05 19:32:39.0,2017-11-05 19:35:26.0,2017-11-05 19:37:50.0,311,167,MSOMNOQ_SWL3,144,3138
2017-11-05 19:41:39.0,2017-11-05 19:44:24.0,2017-11-05 19:46:51.0,312,165,MSOMNOQ_SWL3,147,373
2017-11-08 09:08:44.0,2017-11-08 09:10:15.0,2017-11-08 09:12:34.0,230,91,MSOMNOQ_SWL3,139,221066
2017-11-08 11:32:45.0,2017-11-08 11:35:40.0,2017-11-08 11:38:26.0,341,175,MSOMNOQ_SWL3,166,8550
2017-11-12 19:38:54.0,2017-11-12 19:41:54.0,2017-11-12 19:44:35.0,341,180,MSOMNOQ_SWL3,161,374604
2017-11-13 15:17:55.0,2017-11-13 15:20:57.0,2017-11-13 15:23:37.0,342,182,MSOMNOQ_SWL3,160,70563
2017-11-16 22:46:58.0,2017-11-16 22:47:59.0,2017-11-16 22:52:59.0,361,61,MSOMNOQ_SWL3,300,285312
2017-11-18 10:08:02.0,2017-11-18 10:09:19.0,2017-11-18 10:14:01.0,359,77,MSOMNOQ_SWL3,282,127207
2017-11-18 17:29:02.0,2017-11-18 17:31:04.0,2017-11-18 17:35:02.0,360,122,MSOMNOQ_SWL3,238,26384
2017-11-18 22:59:02.0,2017-11-18 23:01:42.0,2017-11-18 23:04:52.0,350,160,MSOMNOQ_SWL3,190,19679
2017-11-29 05:17:25.0,2017-11-29 05:20:52.0,2017-11-29 05:23:07.0,342,207,MSOMNOQ_SWL3,135,638135
2017-11-30 10:54:06.0,2017-11-30 11:19:14.0,2017-11-30 11:27:09.0,1983,1508,MSOMNOQ_SWL3,475,107258
2017-11-30 11:41:59.0,2017-11-30 11:43:32.0,2017-11-30 11:47:58.0,359,93,MSOMNOQ_SWL3,266,1365
2017-12-06 13:42:45.0,2017-12-06 13:44:13.0,2017-12-06 13:47:58.0,313,88,MSOMNOQ_SWL3,225,525580
2017-12-06 19:20:58.0,2017-12-06 19:22:38.0,2017-12-06 19:26:58.0,360,100,MSOMNOQ_SWL3,260,20207
2017-12-06 19:33:08.0,2017-12-06 19:35:18.0,2017-12-06 19:38:58.0,350,130,MSOMNOQ_SWL3,220,629
2017-12-06 21:11:58.0,2017-12-06 21:14:05.0,2017-12-06 21:17:58.0,360,127,MSOMNOQ_SWL3,233,5801
2017-12-07 15:29:58.0,2017-12-07 15:35:41.0,2017-12-07 15:38:58.0,540,343,MSOMNOQ_SWL3,197,65756
2017-12-08 18:38:58.0,2017-12-08 18:41:05.0,2017-12-08 18:44:58.0,360,127,MSOMNOQ_SWL3,233,97402
2017-12-15 16:17:58.0,2017-12-15 16:34:20.0,2017-12-15 16:54:32.0,2194,982,MSOMNOQ_SWL3,1212,596242
2017-12-17 19:38:58.0,2017-12-17 19:39:41.0,2017-12-17 19:44:58.0,360,43,MSOMNOQ_SWL3,317,183887
2017-12-19 20:44:58.0,2017-12-19 20:45:27.0,2017-12-19 20:50:58.0,360,29,MSOMNOQ_SWL3,331,176726
2017-12-20 16:53:58.0,2017-12-20 16:55:56.0,2017-12-20 16:59:58.0,360,118,MSOMNOQ_SWL3,242,72514
2017-12-21 12:11:59.0,2017-12-21 12:21:23.0,2017-12-21 12:24:33.0,754,564,MSOMNOQ_SWL3,190,69366
2017-12-21 14:35:58.0,2017-12-21 14:38:11.0,2017-12-21 14:41:58.0,360,133,MSOMNOQ_SWL3,227,8075
2017-12-22 17:32:58.0,2017-12-22 17:37:03.0,2017-12-22 17:39:23.0,385,245,MSOMNOQ_SWL3,140,96892
2017-12-28 15:15:07.0,2017-12-28 15:16:15.0,2017-12-28 15:21:07.0,360,68,MSOMNOQ_SWL3,292,509910
2017-12-29 09:57:07.0,2017-12-29 09:58:59.0,2017-12-29 10:03:06.0,359,112,MSOMNOQ_SWL3,247,67255
