dh_ultima_coleta,dh_equip_ligado,dh_primeira_coleta,TempoIndisponivel,TempoIndispAjustado,Equipamento,Uptime,UltimoUptime
2017-09-24 14:51:13.0,2017-09-24 15:06:51.0,2017-09-24 15:11:11.0,1198,938,MSRPTCU_SWL3,260,1323066
2017-09-27 10:54:19.0,2017-09-27 13:37:55.0,2017-09-27 13:42:15.0,10076,9816,MSRPTCU_SWL3,260,244052
2017-10-01 17:21:28.0,2017-10-03 13:15:28.0,2017-10-03 20:21:33.0,183605,158040,MSRPTCU_SWL3,25565,359021
2018-02-23 10:34:19.0,2018-02-23 13:44:56.0,2018-02-23 13:49:18.0,11699,11437,MSRPTCU_SWL3,262,12345127
2018-02-23 13:52:18.0,2018-02-23 15:11:11.0,2018-02-23 15:15:22.0,4984,4733,MSRPTCU_SWL3,251,442
2018-02-26 07:04:33.0,2018-02-26 10:45:51.0,2018-02-26 10:49:59.0,13526,13278,MSRPTCU_SWL3,248,229998
2018-05-03 11:06:51.0,2018-05-03 14:24:04.0,2018-05-03 14:30:51.0,12240,11833,MSRPTCU_SWL3,407,5703778
2018-05-10 12:07:07.0,2018-05-10 13:07:47.0,2018-05-10 13:13:07.0,3960,3640,MSRPTCU_SWL3,320,596594
2018-05-10 14:01:07.0,2018-05-10 14:04:37.0,2018-05-10 14:10:08.0,541,210,MSRPTCU_SWL3,331,3200
2018-05-10 15:31:07.0,2018-05-10 15:37:25.0,2018-05-10 15:43:07.0,720,378,MSRPTCU_SWL3,342,5191
2017-09-24 14:52:10.0,2017-09-24 15:06:15.0,2017-09-24 15:10:10.0,1080,845,SW01A_MSRPTCU,235,1323129
2017-09-27 10:52:15.0,2017-09-27 13:37:19.0,2017-09-27 13:41:19.0,10144,9904,SW01A_MSRPTCU,240,243960
2017-10-01 17:22:24.0,2017-10-03 13:14:55.0,2017-10-03 19:57:59.0,182135,157951,SW01A_MSRPTCU,24184,359104
2018-02-23 10:33:02.0,2018-02-23 13:44:17.0,2018-02-23 13:49:08.0,11766,11475,SW01A_MSRPTCU,291,12344646
2018-02-23 13:49:08.0,2018-02-23 15:10:37.0,2018-02-23 15:14:46.0,5138,4889,SW01A_MSRPTCU,249,291
2018-02-26 07:03:18.0,2018-02-26 10:45:17.0,2018-02-26 10:49:12.0,13554,13319,SW01A_MSRPTCU,235,229945
2018-05-03 11:05:36.0,2018-05-03 14:23:29.0,2018-05-03 14:27:35.0,12119,11873,SW01A_MSRPTCU,246,5703460
2018-05-10 12:05:51.0,2018-05-10 13:07:09.0,2018-05-10 13:11:05.0,3914,3678,SW01A_MSRPTCU,236,596524
2018-05-10 14:00:51.0,2018-05-10 14:04:02.0,2018-05-10 14:07:51.0,420,191,SW01A_MSRPTCU,229,3222
2018-05-10 15:30:51.0,2018-05-10 15:36:50.0,2018-05-10 15:41:34.0,643,359,SW01A_MSRPTCU,284,5209
2017-09-24 14:52:14.0,2017-09-24 15:06:15.0,2017-09-24 15:10:54.0,1120,841,SW01B_MSRPTCU,279,1323133
2017-09-27 10:52:19.0,2017-09-27 13:37:19.0,2017-09-27 13:41:49.0,10170,9900,SW01B_MSRPTCU,270,243964
2017-10-01 17:22:27.0,2017-10-03 13:14:55.0,2017-10-03 19:57:40.0,182113,157948,SW01B_MSRPTCU,24165,359108
2018-02-23 10:33:07.0,2018-02-23 13:44:17.0,2018-02-23 13:48:27.0,11720,11470,SW01B_MSRPTCU,250,12344640
2018-02-23 13:48:27.0,2018-02-23 15:10:36.0,2018-02-23 15:14:46.0,5179,4929,SW01B_MSRPTCU,250,250
2018-02-26 07:03:22.0,2018-02-26 10:45:17.0,2018-02-26 10:49:30.0,13568,13315,SW01B_MSRPTCU,253,229949
2018-05-03 11:05:40.0,2018-05-03 14:23:29.0,2018-05-03 14:27:59.0,12139,11869,SW01B_MSRPTCU,270,5703443
2018-05-10 12:05:56.0,2018-05-10 13:07:09.0,2018-05-10 13:11:16.0,3920,3673,SW01B_MSRPTCU,247,596527
2018-05-10 14:00:55.0,2018-05-10 14:04:02.0,2018-05-10 14:10:55.0,600,187,SW01B_MSRPTCU,413,3227
2018-05-10 15:30:55.0,2018-05-10 15:36:50.0,2018-05-10 15:40:35.0,580,355,SW01B_MSRPTCU,225,5213
2017-09-24 14:53:31.0,2017-09-24 15:06:20.0,2017-09-24 15:10:17.0,1006,769,RD01_MSRPTCU,237,1323205
2017-09-27 10:53:35.0,2017-09-27 13:37:23.0,2017-09-27 13:41:20.0,10065,9828,RD01_MSRPTCU,237,244029
2017-10-01 17:23:44.0,2017-10-03 13:14:59.0,2017-10-03 19:57:52.0,182048,157875,RD01_MSRPTCU,24173,359181
2018-02-23 10:34:23.0,2018-02-23 13:44:21.0,2018-02-23 13:48:45.0,11662,11398,RD01_MSRPTCU,264,12344715
2018-02-23 13:49:23.0,2018-02-23 15:10:40.0,2018-02-23 15:14:22.0,5099,4877,RD01_MSRPTCU,222,301
2018-02-26 07:04:38.0,2018-02-26 10:45:20.0,2018-02-26 10:49:43.0,13505,13242,RD01_MSRPTCU,263,230021
2018-05-03 11:06:56.0,2018-05-03 14:23:33.0,2018-05-03 14:27:54.0,12058,11797,RD01_MSRPTCU,261,5703532
2018-05-10 12:07:12.0,2018-05-10 13:07:12.0,2018-05-10 13:11:30.0,3858,3600,RD01_MSRPTCU,258,596601
2018-05-10 13:57:12.0,2018-05-10 14:04:05.0,2018-05-10 14:08:32.0,680,413,RD01_MSRPTCU,267,2999
2018-05-10 15:32:12.0,2018-05-10 15:36:54.0,2018-05-10 15:42:11.0,599,282,RD01_MSRPTCU,317,5286
2017-09-24 14:53:35.0,2017-09-24 15:06:20.0,2017-09-24 15:13:34.0,1199,765,RD02_MSRPTCU,434,1323209
2017-09-27 10:53:40.0,2017-09-27 13:37:23.0,2017-09-27 13:41:21.0,10061,9823,RD02_MSRPTCU,238,244033
2017-10-01 17:23:48.0,2017-10-03 13:14:59.0,2017-10-03 19:57:53.0,182045,157871,RD02_MSRPTCU,24174,359185
2018-02-23 10:34:27.0,2018-02-23 13:44:21.0,2018-02-23 13:48:46.0,11659,11394,RD02_MSRPTCU,265,12344718
2018-02-23 13:49:27.0,2018-02-23 15:10:40.0,2018-02-23 15:14:23.0,5096,4873,RD02_MSRPTCU,223,305
2018-02-26 07:04:42.0,2018-02-26 10:45:21.0,2018-02-26 10:49:17.0,13475,13239,RD02_MSRPTCU,236,230025
2018-05-03 11:07:01.0,2018-05-03 14:23:33.0,2018-05-03 14:27:19.0,12018,11792,RD02_MSRPTCU,226,5703534
2018-05-10 12:07:15.0,2018-05-10 13:07:12.0,2018-05-10 13:11:13.0,3838,3597,RD02_MSRPTCU,241,596604
2018-05-10 13:57:16.0,2018-05-10 14:04:06.0,2018-05-10 14:12:16.0,900,410,RD02_MSRPTCU,490,3003
2018-05-10 15:32:17.0,2018-05-10 15:36:55.0,2018-05-10 15:42:16.0,599,278,RD02_MSRPTCU,321,5290
2017-09-24 14:53:39.0,2017-09-24 15:06:20.0,2017-09-24 15:13:38.0,1199,761,RD03_MSRPTCU,438,1323213
2017-09-27 10:53:44.0,2017-09-27 13:37:23.0,2017-09-27 13:41:23.0,10059,9819,RD03_MSRPTCU,240,244044
2017-10-01 17:23:52.0,2017-10-03 13:14:59.0,2017-10-03 19:58:56.0,182104,157867,RD03_MSRPTCU,24237,359189
2018-02-23 10:34:31.0,2018-02-23 13:44:21.0,2018-02-23 13:49:01.0,11670,11390,RD03_MSRPTCU,280,12344716
2018-02-23 13:49:30.0,2018-02-23 15:10:40.0,2018-02-23 15:14:59.0,5129,4870,RD03_MSRPTCU,259,309
2018-02-26 07:04:45.0,2018-02-26 10:45:20.0,2018-02-26 10:50:00.0,13515,13235,RD03_MSRPTCU,280,230028
2018-05-03 11:07:05.0,2018-05-03 14:23:33.0,2018-05-03 14:28:23.0,12078,11788,RD03_MSRPTCU,290,5703512
2018-05-10 12:07:20.0,2018-05-10 13:07:12.0,2018-05-10 13:12:03.0,3883,3592,RD03_MSRPTCU,291,596606
2018-05-10 13:57:20.0,2018-05-10 14:04:06.0,2018-05-10 14:12:20.0,900,406,RD03_MSRPTCU,494,3007
2018-05-10 15:27:20.0,2018-05-10 15:36:54.0,2018-05-10 15:41:20.0,840,574,RD03_MSRPTCU,266,4994
2017-09-24 14:53:43.0,2017-09-24 15:06:20.0,2017-09-24 15:13:42.0,1199,757,RD04_MSRPTCU,442,1323217
2017-09-27 10:53:48.0,2017-09-27 13:37:24.0,2017-09-27 13:41:28.0,10060,9816,RD04_MSRPTCU,244,244047
2017-10-01 17:23:57.0,2017-10-03 13:15:00.0,2017-10-03 19:57:29.0,182012,157863,RD04_MSRPTCU,24149,359192
2018-02-23 10:34:36.0,2018-02-23 13:44:22.0,2018-02-23 13:48:42.0,11646,11386,RD04_MSRPTCU,260,12344723
2018-02-23 13:49:36.0,2018-02-23 15:10:41.0,2018-02-23 15:15:19.0,5143,4865,RD04_MSRPTCU,278,313
2018-02-26 07:04:51.0,2018-02-26 10:45:21.0,2018-02-26 10:49:34.0,13483,13230,RD04_MSRPTCU,253,230032
2018-05-03 11:07:09.0,2018-05-03 14:23:34.0,2018-05-03 14:27:18.0,12009,11785,RD04_MSRPTCU,224,5703530
2018-05-10 12:07:24.0,2018-05-10 13:07:14.0,2018-05-10 13:11:37.0,3853,3590,RD04_MSRPTCU,263,596610
2018-05-10 13:57:24.0,2018-05-10 14:04:06.0,2018-05-10 14:07:51.0,627,402,RD04_MSRPTCU,225,3010
2018-05-10 15:27:24.0,2018-05-10 15:36:55.0,2018-05-10 15:41:27.0,843,571,RD04_MSRPTCU,272,4997
