dh_ultima_coleta,dh_equip_ligado,dh_primeira_coleta,TempoIndisponivel,TempoIndispAjustado,Equipamento,Uptime,UltimoUptime
2017-10-02 05:46:33.0,2017-10-03 19:54:14.0,2017-10-03 20:21:04.0,138871,137261,MSRPPPR_SWL3,1610,6416292
2017-10-23 16:08:17.0,2017-10-23 16:09:28.0,2017-10-23 16:14:16.0,359,71,MSRPPPR_SWL3,288,1710874
2017-10-28 02:26:27.0,2017-10-28 12:39:35.0,2017-10-28 13:37:33.0,40266,36788,MSRPPPR_SWL3,3478,382625
2018-03-19 19:12:15.0,2018-03-19 19:30:48.0,2018-03-19 19:42:15.0,1800,1113,MSRPPPR_SWL3,687,12296600
2017-10-02 05:46:51.0,2017-10-03 19:53:34.0,2017-10-03 21:48:31.0,144100,137203,SW01A_MSRPPPR,6897,3258289
2017-10-28 02:22:44.0,2017-10-28 12:38:59.0,2017-10-28 14:25:05.0,43341,36975,SW01A_MSRPPPR,6366,2093351
2017-10-28 14:32:45.0,2017-10-28 14:34:41.0,2017-10-28 14:37:46.0,301,116,SW01A_MSRPPPR,185,6826
2017-10-02 05:46:52.0,2017-10-03 19:53:34.0,2017-10-03 21:48:13.0,144081,137202,SW01B_MSRPPPR,6879,18865326
2017-10-28 02:22:45.0,2017-10-28 12:38:59.0,2017-10-28 13:37:28.0,40483,36974,SW01B_MSRPPPR,3509,2093352
2017-10-02 05:46:57.0,2017-10-03 19:53:34.0,2017-10-03 21:49:32.0,144155,137197,SW02A_MSRPPPR,6958,6415964
2017-10-28 02:22:50.0,2017-10-28 12:38:59.0,2017-10-28 13:37:31.0,40481,36969,SW02A_MSRPPPR,3512,2093357
2018-01-24 17:10:37.0,2018-01-24 17:11:39.0,2018-01-24 17:15:37.0,300,62,SW02A_MSRPPPR,238,7619683
2017-10-02 05:46:09.0,2017-10-03 19:53:34.0,2017-10-03 21:48:26.0,144137,137245,SW02B_MSRPPPR,6892,6415962
2017-10-28 02:27:02.0,2017-10-28 12:38:59.0,2017-10-28 13:38:31.0,40289,36717,SW02B_MSRPPPR,3572,2093609
2017-09-12 11:41:06.0,2017-09-12 16:46:27.0,2017-09-12 16:48:33.0,18447,18321,RD01_MSRPPPR,126,1073
2017-09-12 16:51:07.0,2017-09-20 21:04:15.0,2017-09-20 21:11:27.0,706820,706388,RD01_MSRPPPR,432,280
2017-09-20 21:11:27.0,2017-09-20 21:15:20.0,2017-09-20 21:19:15.0,468,233,RD01_MSRPPPR,235,432
2017-09-21 09:36:25.0,2017-09-21 09:37:48.0,2017-09-21 09:41:24.0,299,83,RD01_MSRPPPR,216,44463
2017-09-21 10:51:24.0,2017-09-21 10:53:21.0,2017-09-21 10:56:24.0,300,117,RD01_MSRPPPR,183,4416
2017-09-21 10:56:24.0,2017-09-21 12:29:25.0,2017-09-21 12:31:33.0,5709,5581,RD01_MSRPPPR,128,183
2017-09-21 12:31:33.0,2017-09-21 12:42:13.0,2017-09-21 12:44:49.0,796,640,RD01_MSRPPPR,156,128
2017-09-21 13:26:25.0,2017-09-21 13:29:52.0,2017-09-21 13:36:25.0,600,207,RD01_MSRPPPR,393,2651
2017-09-21 13:41:25.0,2017-09-21 13:46:32.0,2017-09-21 13:57:44.0,979,307,RD01_MSRPPPR,672,692
2017-09-21 14:01:26.0,2017-09-21 14:09:07.0,2017-09-21 14:19:08.0,1062,461,RD01_MSRPPPR,601,894
2017-10-02 05:46:47.0,2017-10-03 19:53:38.0,2017-10-03 21:47:46.0,144059,137211,RD01_MSRPPPR,6848,920261
2017-10-09 15:47:02.0,2017-10-09 17:52:09.0,2017-10-09 17:57:02.0,7800,7507,RD01_MSRPPPR,293,503604
2017-10-09 17:57:02.0,2017-10-09 17:59:30.0,2017-10-09 18:02:02.0,300,148,RD01_MSRPPPR,152,293
2017-10-09 18:07:02.0,2017-10-09 18:14:41.0,2017-10-09 18:22:02.0,900,459,RD01_MSRPPPR,441,452
2017-10-09 18:42:02.0,2017-10-09 18:47:53.0,2017-10-09 18:52:02.0,600,351,RD01_MSRPPPR,249,1640
2017-10-09 18:57:03.0,2017-10-09 19:00:10.0,2017-10-09 19:07:02.0,599,187,RD01_MSRPPPR,412,549
2017-10-09 19:07:02.0,2017-10-09 19:14:45.0,2017-10-09 19:17:35.0,633,463,RD01_MSRPPPR,170,412
2017-10-09 19:37:03.0,2017-10-09 20:13:26.0,2017-10-09 20:25:55.0,2932,2183,RD01_MSRPPPR,749,1337
2017-10-09 20:27:02.0,2017-10-09 20:28:50.0,2017-10-09 20:32:03.0,301,108,RD01_MSRPPPR,193,816
2017-10-10 14:27:04.0,2017-10-10 14:32:15.0,2017-10-10 14:34:55.0,471,311,RD01_MSRPPPR,160,64694
2017-10-10 14:37:04.0,2017-10-10 14:39:41.0,2017-10-10 14:47:05.0,601,157,RD01_MSRPPPR,444,289
2017-10-21 14:02:28.0,2017-10-21 14:04:27.0,2017-10-21 14:07:27.0,299,119,RD01_MSRPPPR,180,944567
2017-10-21 14:12:27.0,2017-10-21 14:17:48.0,2017-10-21 14:20:09.0,462,321,RD01_MSRPPPR,141,480
2017-10-27 17:52:40.0,2017-10-27 17:57:21.0,2017-10-27 18:02:40.0,600,281,RD01_MSRPPPR,319,531292
2017-10-27 18:02:40.0,2017-10-27 18:07:36.0,2017-10-27 18:09:52.0,432,296,RD01_MSRPPPR,136,319
2017-10-27 18:57:40.0,2017-10-27 19:07:12.0,2017-10-27 19:09:14.0,694,572,RD01_MSRPPPR,122,3003
2017-10-27 19:17:40.0,2017-10-27 19:20:21.0,2017-10-27 19:22:40.0,300,161,RD01_MSRPPPR,139,628
2017-10-27 19:27:39.0,2017-10-27 19:31:38.0,2017-10-27 19:37:40.0,601,239,RD01_MSRPPPR,362,438
2017-10-28 02:22:41.0,2017-10-28 14:13:51.0,2017-10-28 14:25:32.0,43371,42670,RD01_MSRPPPR,701,24663
2017-10-31 18:32:48.0,2017-10-31 18:33:49.0,2017-10-31 18:37:49.0,301,61,RD01_MSRPPPR,240,274737
2017-11-10 13:53:08.0,2017-11-10 14:10:40.0,2017-11-10 14:12:44.0,1176,1052,RD01_MSRPPPR,124,847160
2017-11-10 14:13:08.0,2017-11-10 14:18:59.0,2017-11-10 14:23:09.0,601,351,RD01_MSRPPPR,250,149
2017-11-13 19:53:15.0,2017-11-13 20:07:37.0,2017-11-13 20:13:16.0,1201,862,RD01_MSRPPPR,339,279256
2017-11-13 21:03:17.0,2017-11-13 21:10:52.0,2017-11-13 21:13:38.0,621,455,RD01_MSRPPPR,166,3004
2017-11-24 13:10:25.0,2017-11-24 13:15:03.0,2017-11-24 13:17:37.0,432,278,RD01_MSRPPPR,154,921759
2017-11-24 13:17:37.0,2017-11-24 13:37:25.0,2017-11-24 13:39:51.0,1334,1188,RD01_MSRPPPR,146,154
2017-11-24 13:55:25.0,2017-11-24 13:57:23.0,2017-11-24 14:00:25.0,300,118,RD01_MSRPPPR,182,1080
2017-11-24 14:05:26.0,2017-11-24 14:11:32.0,2017-11-24 14:15:26.0,600,366,RD01_MSRPPPR,234,483
2017-12-09 21:13:28.0,2017-12-09 21:23:53.0,2017-12-09 21:30:26.0,1018,625,RD01_MSRPPPR,393,1321315
2018-01-24 17:10:27.0,2018-01-24 17:13:41.0,2018-01-24 17:20:28.0,601,194,RD01_MSRPPPR,407,3959194
2017-10-02 05:46:48.0,2017-10-03 19:53:38.0,2017-10-03 21:47:58.0,144070,137210,RD02_MSRPPPR,6860,6415973
2017-10-27 18:57:41.0,2017-10-27 18:59:13.0,2017-10-27 19:02:41.0,300,92,RD02_MSRPPPR,208,2066643
2017-10-28 02:22:42.0,2017-10-28 12:39:02.0,2017-10-28 13:37:31.0,40489,36980,RD02_MSRPPPR,3509,26608
2017-12-09 21:05:27.0,2017-12-09 21:23:57.0,2017-12-09 21:25:47.0,1220,1110,RD02_MSRPPPR,110,3659369
2018-01-24 17:10:28.0,2018-01-24 17:14:15.0,2018-01-24 17:20:28.0,600,227,RD02_MSRPPPR,373,3959191
2017-10-02 05:46:50.0,2017-10-03 20:09:44.0,2017-10-03 21:48:43.0,144113,138174,RD03_MSRPPPR,5939,6415610
2017-10-09 18:42:05.0,2017-10-09 18:47:59.0,2017-10-09 18:52:05.0,600,354,RD03_MSRPPPR,246,513141
2017-10-09 18:57:04.0,2017-10-09 19:06:53.0,2017-10-09 19:12:04.0,900,589,RD03_MSRPPPR,311,546
2017-10-28 02:22:42.0,2017-10-28 12:39:02.0,2017-10-28 13:37:48.0,40506,36980,RD03_MSRPPPR,3526,1577750
2018-01-01 12:20:29.0,2018-01-01 12:21:05.0,2018-01-01 12:25:28.0,299,36,RD03_MSRPPPR,263,5615071
2018-01-01 13:05:28.0,2018-01-01 13:06:03.0,2018-01-01 13:10:28.0,300,35,RD03_MSRPPPR,265,2664
2018-01-01 13:10:28.0,2018-01-01 13:15:31.0,2018-01-01 13:18:11.0,463,303,RD03_MSRPPPR,160,265
2018-01-01 16:10:29.0,2018-01-01 16:14:13.0,2018-01-01 16:20:28.0,599,224,RD03_MSRPPPR,375,10497
2018-01-01 16:45:28.0,2018-01-01 16:49:57.0,2018-01-01 16:52:18.0,410,269,RD03_MSRPPPR,141,1875
2018-01-26 10:35:29.0,2018-01-26 10:39:42.0,2018-01-26 10:45:30.0,601,253,RD03_MSRPPPR,348,2137532
2018-01-26 10:50:29.0,2018-01-26 10:51:24.0,2018-01-26 10:55:29.0,300,55,RD03_MSRPPPR,245,647
2018-02-20 17:22:38.0,2018-02-20 17:27:29.0,2018-02-20 17:32:38.0,600,291,RD03_MSRPPPR,309,2186027
2018-02-20 18:17:54.0,2018-02-20 18:23:29.0,2018-02-20 18:25:27.0,453,335,RD03_MSRPPPR,118,1033
2018-02-20 18:27:38.0,2018-02-20 18:29:37.0,2018-02-20 18:32:38.0,300,119,RD03_MSRPPPR,181,249
2018-02-20 18:32:38.0,2018-02-20 18:37:35.0,2018-02-20 18:42:38.0,600,297,RD03_MSRPPPR,303,181
2017-10-02 05:46:50.0,2017-10-03 19:53:38.0,2017-10-03 21:49:07.0,144137,137208,RD04_MSRPPPR,6929,6416014
2017-10-28 02:22:44.0,2017-10-28 12:39:03.0,2017-10-28 14:28:50.0,43566,36979,RD04_MSRPPPR,6587,2093346
2018-03-19 19:05:32.0,2018-03-19 19:09:43.0,2018-03-19 19:35:46.0,1814,251,RD04_MSRPPPR,1563,12295736
2017-10-02 05:42:50.0,2017-10-03 19:53:38.0,2017-10-03 21:48:35.0,144345,137448,RD08_MSRPPPR,6897,6415694
2017-10-28 02:23:42.0,2017-10-28 12:39:02.0,2017-10-28 14:26:01.0,43339,36920,RD08_MSRPPPR,6419,2093405
2018-01-09 12:36:29.0,2018-01-09 12:40:43.0,2018-01-09 12:46:29.0,600,254,RD08_MSRPPPR,346,6307231
2017-10-02 05:42:52.0,2017-10-03 19:53:38.0,2017-10-03 21:49:32.0,144400,137446,RD07_MSRPPPR,6954,6415696
2017-10-21 13:58:31.0,2017-10-21 14:03:12.0,2017-10-21 14:08:31.0,600,281,RD07_MSRPPPR,319,1530293
2017-10-27 18:53:44.0,2017-10-27 18:59:02.0,2017-10-27 19:01:09.0,445,318,RD07_MSRPPPR,127,535833
2017-10-27 19:01:09.0,2017-10-27 19:09:09.0,2017-10-27 19:13:43.0,754,480,RD07_MSRPPPR,274,127
2017-10-27 19:18:44.0,2017-10-27 19:20:39.0,2017-10-27 19:23:45.0,301,115,RD07_MSRPPPR,186,574
2017-10-28 02:23:45.0,2017-10-28 12:39:03.0,2017-10-28 13:37:50.0,40445,36918,RD07_MSRPPPR,3527,25386
2017-10-28 13:53:46.0,2017-10-28 14:03:30.0,2017-10-28 14:05:55.0,729,584,RD07_MSRPPPR,145,4483
2017-10-28 14:13:46.0,2017-10-28 14:22:05.0,2017-10-28 14:28:46.0,900,499,RD07_MSRPPPR,401,615
2017-10-28 14:33:46.0,2017-10-28 14:37:12.0,2017-10-28 14:51:37.0,1071,206,RD07_MSRPPPR,865,700
2017-10-28 14:58:52.0,2017-10-28 15:00:38.0,2017-10-28 15:03:46.0,294,106,RD07_MSRPPPR,188,1299
2017-11-06 16:04:05.0,2017-11-06 16:05:10.0,2017-11-06 16:09:05.0,300,65,RD07_MSRPPPR,235,781407
2017-11-10 13:54:13.0,2017-11-10 14:01:51.0,2017-11-10 14:11:37.0,1044,458,RD07_MSRPPPR,586,337743
2017-11-10 14:11:37.0,2017-11-10 14:15:38.0,2017-11-10 14:17:56.0,379,241,RD07_MSRPPPR,138,586
2017-11-13 20:39:20.0,2017-11-13 20:45:17.0,2017-11-13 20:49:20.0,600,357,RD07_MSRPPPR,243,282221
2017-11-13 21:09:20.0,2017-11-24 12:42:49.0,2017-11-24 12:45:27.0,920167,920009,RD07_MSRPPPR,158,1443
2017-11-24 12:45:27.0,2017-11-24 13:01:27.0,2017-11-24 13:04:22.0,1135,960,RD07_MSRPPPR,175,158
2017-11-24 13:16:29.0,2017-11-24 13:21:28.0,2017-11-24 13:26:29.0,600,299,RD07_MSRPPPR,301,902
2018-01-26 09:06:32.0,2018-01-26 09:07:49.0,2018-01-26 09:11:32.0,300,77,RD07_MSRPPPR,223,5427901
2018-02-10 16:48:25.0,2018-02-10 16:49:16.0,2018-02-10 16:53:25.0,300,51,RD07_MSRPPPR,249,1322622
2017-10-02 05:46:50.0,2017-10-03 19:53:38.0,2017-10-03 21:50:02.0,144192,137208,RD05_MSRPPPR,6984,6415559
2017-10-21 13:52:30.0,2017-10-21 13:58:06.0,2017-10-21 14:00:10.0,460,336,RD05_MSRPPPR,124,1529932
2017-10-27 19:02:43.0,2017-10-27 19:09:48.0,2017-10-27 19:12:43.0,600,425,RD05_MSRPPPR,175,536675
2017-10-27 19:22:43.0,2017-10-27 19:27:44.0,2017-10-27 19:32:43.0,600,301,RD05_MSRPPPR,299,775
2017-10-28 02:22:43.0,2017-10-28 12:39:03.0,2017-10-28 13:38:16.0,40533,36980,RD05_MSRPPPR,3553,24899
2017-10-28 13:47:44.0,2017-10-28 14:04:06.0,2017-10-28 14:06:58.0,1154,982,RD05_MSRPPPR,172,4121
2017-10-28 14:17:45.0,2017-10-28 14:22:11.0,2017-10-28 14:27:45.0,600,266,RD05_MSRPPPR,334,818
2017-11-10 14:08:11.0,2017-11-10 14:19:05.0,2017-11-10 14:22:03.0,832,654,RD05_MSRPPPR,178,1122362
2018-01-26 10:15:29.0,2018-01-26 10:19:49.0,2018-01-26 10:25:29.0,600,260,RD05_MSRPPPR,340,6638369
2018-01-26 10:35:30.0,2018-01-26 10:37:12.0,2018-01-26 10:40:30.0,300,102,RD05_MSRPPPR,198,940
2018-02-20 17:57:38.0,2018-02-20 18:00:40.0,2018-02-20 18:07:38.0,600,182,RD05_MSRPPPR,418,2188991
2018-02-20 18:12:38.0,2018-02-20 19:09:01.0,2018-02-20 19:11:10.0,3512,3383,RD05_MSRPPPR,129,717
2018-03-05 17:43:08.0,2018-04-04 17:09:12.0,2018-04-04 17:24:48.0,2590900,2589964,RD05_MSRPPPR,936,1118008
2017-09-12 11:41:11.0,2017-09-12 11:46:11.0,2017-09-12 11:51:11.0,600,300,RD06_MSRPPPR,300,4709321
2017-09-12 12:11:11.0,2017-09-12 12:16:32.0,2017-09-12 12:18:30.0,439,321,RD06_MSRPPPR,118,1500
2017-10-02 05:46:53.0,2017-10-03 19:53:38.0,2017-10-03 21:49:30.0,144157,137205,RD06_MSRPPPR,6952,1704572
2017-10-28 02:22:46.0,2017-10-28 12:39:02.0,2017-10-28 13:38:38.0,40552,36976,RD06_MSRPPPR,3576,2093289
