dh_ultima_coleta,dh_equip_ligado,dh_primeira_coleta,TempoIndisponivel,TempoIndispAjustado,Equipamento,Uptime,UltimoUptime
2017-09-01 16:50:05.0,2017-09-01 18:23:17.0,2017-09-01 18:27:14.0,5829,5592,MSRPTCU_SWL3,237,2440815
2017-09-07 02:50:35.0,2017-09-07 16:16:14.0,2017-09-07 16:19:45.0,48550,48339,MSRPTCU_SWL3,211,462429
2017-09-09 07:05:41.0,2017-09-09 07:20:33.0,2017-09-09 07:24:40.0,1139,892,MSRPTCU_SWL3,247,139770
2017-09-24 14:51:13.0,2017-09-24 15:06:51.0,2017-09-24 15:11:11.0,1198,938,MSRPTCU_SWL3,260,1323066
2017-09-27 10:54:19.0,2017-09-27 13:37:55.0,2017-09-27 13:42:15.0,10076,9816,MSRPTCU_SWL3,260,244052
2017-10-01 17:21:28.0,2017-10-03 13:15:28.0,2017-10-03 20:21:33.0,183605,158040,MSRPTCU_SWL3,25565,359021
2018-02-23 10:34:19.0,2018-02-23 13:44:56.0,2018-02-23 13:49:18.0,11699,11437,MSRPTCU_SWL3,262,12345127
2018-02-23 13:52:18.0,2018-02-23 15:11:11.0,2018-02-23 15:15:22.0,4984,4733,MSRPTCU_SWL3,251,442
2018-02-26 07:04:33.0,2018-02-26 10:45:51.0,2018-02-26 10:49:59.0,13526,13278,MSRPTCU_SWL3,248,229998
2017-09-01 16:46:04.0,2017-09-01 18:34:10.0,2017-09-02 13:30:42.0,74678,6486,SW01A_MSRPTCU,68192,2435772
2017-09-07 02:51:34.0,2017-09-07 16:15:37.0,2017-09-07 16:19:45.0,48491,48243,SW01A_MSRPTCU,248,462501
2017-09-09 07:01:38.0,2017-09-09 07:19:57.0,2017-09-09 07:24:06.0,1348,1099,SW01A_MSRPTCU,249,139558
2017-09-24 14:52:10.0,2017-09-24 15:06:15.0,2017-09-24 15:10:10.0,1080,845,SW01A_MSRPTCU,235,1323129
2017-09-27 10:52:15.0,2017-09-27 13:37:19.0,2017-09-27 13:41:19.0,10144,9904,SW01A_MSRPTCU,240,243960
2017-10-01 17:22:24.0,2017-10-03 13:14:55.0,2017-10-03 19:57:59.0,182135,157951,SW01A_MSRPTCU,24184,359104
2018-02-23 10:33:02.0,2018-02-23 13:44:17.0,2018-02-23 13:49:08.0,11766,11475,SW01A_MSRPTCU,291,12344646
2018-02-23 13:49:08.0,2018-02-23 15:10:37.0,2018-02-23 15:14:46.0,5138,4889,SW01A_MSRPTCU,249,291
2018-02-26 07:03:18.0,2018-02-26 10:45:17.0,2018-02-26 10:49:12.0,13554,13319,SW01A_MSRPTCU,235,229945
2017-09-01 16:46:08.0,2017-09-01 18:34:10.0,2017-09-02 13:32:31.0,74783,6482,SW01B_MSRPTCU,68301,2435176
2017-09-07 02:51:37.0,2017-09-07 16:15:36.0,2017-09-07 16:20:17.0,48520,48239,SW01B_MSRPTCU,281,462502
2017-09-09 07:01:43.0,2017-09-09 07:19:57.0,2017-09-09 07:23:43.0,1320,1094,SW01B_MSRPTCU,226,139561
2017-09-24 14:52:14.0,2017-09-24 15:06:15.0,2017-09-24 15:10:54.0,1120,841,SW01B_MSRPTCU,279,1323133
2017-09-27 10:52:19.0,2017-09-27 13:37:19.0,2017-09-27 13:41:49.0,10170,9900,SW01B_MSRPTCU,270,243964
2017-10-01 17:22:27.0,2017-10-03 13:14:55.0,2017-10-03 19:57:40.0,182113,157948,SW01B_MSRPTCU,24165,359108
2018-02-23 10:33:07.0,2018-02-23 13:44:17.0,2018-02-23 13:48:27.0,11720,11470,SW01B_MSRPTCU,250,12344640
2018-02-23 13:48:27.0,2018-02-23 15:10:36.0,2018-02-23 15:14:46.0,5179,4929,SW01B_MSRPTCU,250,250
2018-02-26 07:03:22.0,2018-02-26 10:45:17.0,2018-02-26 10:49:30.0,13568,13315,SW01B_MSRPTCU,253,229949
2017-09-01 16:47:24.0,2017-09-01 18:34:13.0,2017-09-02 13:31:12.0,74628,6409,RD01_MSRPTCU,68219,2440573
2017-09-07 02:47:54.0,2017-09-07 16:15:40.0,2017-09-07 16:19:47.0,48713,48466,RD01_MSRPTCU,247,462276
2017-09-09 07:02:59.0,2017-09-09 07:20:01.0,2017-09-09 07:27:59.0,1500,1022,RD01_MSRPTCU,478,139634
2017-09-24 14:53:31.0,2017-09-24 15:06:20.0,2017-09-24 15:10:17.0,1006,769,RD01_MSRPTCU,237,1323205
2017-09-27 10:53:35.0,2017-09-27 13:37:23.0,2017-09-27 13:41:20.0,10065,9828,RD01_MSRPTCU,237,244029
2017-10-01 17:23:44.0,2017-10-03 13:14:59.0,2017-10-03 19:57:52.0,182048,157875,RD01_MSRPTCU,24173,359181
2018-02-23 10:34:23.0,2018-02-23 13:44:21.0,2018-02-23 13:48:45.0,11662,11398,RD01_MSRPTCU,264,12344715
2018-02-23 13:49:23.0,2018-02-23 15:10:40.0,2018-02-23 15:14:22.0,5099,4877,RD01_MSRPTCU,222,301
2018-02-26 07:04:38.0,2018-02-26 10:45:20.0,2018-02-26 10:49:43.0,13505,13242,RD01_MSRPTCU,263,230021
2017-09-01 16:47:29.0,2017-09-01 18:34:14.0,2017-09-02 13:32:40.0,74711,6405,RD02_MSRPTCU,68306,2440578
2017-09-07 02:47:59.0,2017-09-07 16:15:40.0,2017-09-07 16:19:46.0,48707,48461,RD02_MSRPTCU,246,462281
2017-09-09 07:03:03.0,2017-09-09 07:20:02.0,2017-09-09 07:28:03.0,1500,1019,RD02_MSRPTCU,481,139638
2017-09-24 14:53:35.0,2017-09-24 15:06:20.0,2017-09-24 15:13:34.0,1199,765,RD02_MSRPTCU,434,1323209
2017-09-27 10:53:40.0,2017-09-27 13:37:23.0,2017-09-27 13:41:21.0,10061,9823,RD02_MSRPTCU,238,244033
2017-10-01 17:23:48.0,2017-10-03 13:14:59.0,2017-10-03 19:57:53.0,182045,157871,RD02_MSRPTCU,24174,359185
2018-02-23 10:34:27.0,2018-02-23 13:44:21.0,2018-02-23 13:48:46.0,11659,11394,RD02_MSRPTCU,265,12344718
2018-02-23 13:49:27.0,2018-02-23 15:10:40.0,2018-02-23 15:14:23.0,5096,4873,RD02_MSRPTCU,223,305
2018-02-26 07:04:42.0,2018-02-26 10:45:21.0,2018-02-26 10:49:17.0,13475,13239,RD02_MSRPTCU,236,230025
2017-09-01 16:47:32.0,2017-09-01 18:34:13.0,2017-09-02 13:31:25.0,74633,6401,RD03_MSRPTCU,68232,2440575
2017-09-07 02:48:03.0,2017-09-07 16:15:39.0,2017-09-07 16:20:05.0,48722,48456,RD03_MSRPTCU,266,462283
2017-09-09 07:03:08.0,2017-09-09 07:20:02.0,2017-09-09 07:28:08.0,1500,1014,RD03_MSRPTCU,486,139642
2017-09-24 14:53:39.0,2017-09-24 15:06:20.0,2017-09-24 15:13:38.0,1199,761,RD03_MSRPTCU,438,1323213
2017-09-27 10:53:44.0,2017-09-27 13:37:23.0,2017-09-27 13:41:23.0,10059,9819,RD03_MSRPTCU,240,244044
2017-10-01 17:23:52.0,2017-10-03 13:14:59.0,2017-10-03 19:58:56.0,182104,157867,RD03_MSRPTCU,24237,359189
2018-02-23 10:34:31.0,2018-02-23 13:44:21.0,2018-02-23 13:49:01.0,11670,11390,RD03_MSRPTCU,280,12344716
2018-02-23 13:49:30.0,2018-02-23 15:10:40.0,2018-02-23 15:14:59.0,5129,4870,RD03_MSRPTCU,259,309
2018-02-26 07:04:45.0,2018-02-26 10:45:20.0,2018-02-26 10:50:00.0,13515,13235,RD03_MSRPTCU,280,230028
2017-09-01 16:47:37.0,2017-09-01 18:34:14.0,2017-09-02 13:30:55.0,74598,6397,RD04_MSRPTCU,68201,2440581
2017-09-07 02:48:07.0,2017-09-07 16:15:41.0,2017-09-07 16:20:12.0,48725,48454,RD04_MSRPTCU,271,462287
2017-09-09 07:03:12.0,2017-09-09 07:20:02.0,2017-09-09 07:28:11.0,1499,1010,RD04_MSRPTCU,489,139645
2017-09-24 14:53:43.0,2017-09-24 15:06:20.0,2017-09-24 15:13:42.0,1199,757,RD04_MSRPTCU,442,1323217
2017-09-27 10:53:48.0,2017-09-27 13:37:24.0,2017-09-27 13:41:28.0,10060,9816,RD04_MSRPTCU,244,244047
2017-10-01 17:23:57.0,2017-10-03 13:15:00.0,2017-10-03 19:57:29.0,182012,157863,RD04_MSRPTCU,24149,359192
2018-02-23 10:34:36.0,2018-02-23 13:44:22.0,2018-02-23 13:48:42.0,11646,11386,RD04_MSRPTCU,260,12344723
2018-02-23 13:49:36.0,2018-02-23 15:10:41.0,2018-02-23 15:15:19.0,5143,4865,RD04_MSRPTCU,278,313
2018-02-26 07:04:51.0,2018-02-26 10:45:21.0,2018-02-26 10:49:34.0,13483,13230,RD04_MSRPTCU,253,230032
